vaselin = n zat lemak yang terbuat dari minyak bumi, digunakan untuk bahan campuran pembuat salep, pomade, pelumas, dan sebagainya
abang = n kakak laki-laki; saudara laki-laki yang lebih tua: --nya tiga tahun lebih tua|n kata sapaan kepada orang laki-laki yang lebih tua atau tidak dikenal: tahukah -- jalan ke kantor pos?|n kata sapaan istri kepada suami: sudah dua hari -- tidak pulang|n kata sapaan kepada penjual sayur, penjual ikan, pengemudi becak, dan sebagainya: ia biasa belanja pada -- sayur yang lewat di depan rumahnya|n kata sapaan untuk saudara laki-laki ayah di kalangan kaum bangsawan Banggai di Sulawesi
untai = n benang (tali) yang dipakai untuk mencocok merjan, mutiara, dan sebagainya|n kata penggolong bagi barang yang dicocok (seperti kalung merjan, petasan); rentengan: se-- kalung mutiara|n satuan sajak (syair), serangkai sajak; satu kuplet (sajak, nyanyian): tiap-tiap bait atau -- berisi beberapa baris; baris-baris dalam -- itu kita sebut larik|n Bot perbungaan berupa bulir, berkelamin tunggal, umumnya menggantung dan tanggal sebagai satu satuan sesudah pembuahan
vandal = n perusak hasil karya seni dan barang berharga lain (lukisan, patung, dan sebagainya)|n orang yang suka merusak dan menghancurkan secara kasar dan ganas
wiraswasta = n orang yang pandai atau berbakat mengenali produk baru, menentukan cara produksi baru, menyusun operasi untuk pengadaan produk baru, |memasarkannya, serta mengatur permodalan operasinya
xilem = n jaringan pembuluh kayu, khususnya tumbuhan tinggi, yang merupakan sel penyokong dan pengalir-alir ikatan vaskular|n jaringan pembuluh pada tumbuhan tinggi yang terdiri atas trakeid berlignin, unsur pembuluh dan serat yang menghantar air dan|garam-garam mineral yang diserap oleh akar ke seluruh bagian, menopang tubuh secara mekanis
unjuk = v mengunjuk|v beri tahu
xenograf = n ahli dalam membaca tulisan (naskah) bahasa asing
yogi = Etimologi: [Informasi etimologi hanya tersedia bagi pengguna terdaftar]|n pendeta (petapa) bangsa Hindu|n orang yang mahir tentang yoga; ahli (guru) yoga
zoologi = n ilmu tentang kehidupan binatang dan pembuatan klasifikasi aneka macam bentuk binatang di dunia; ilmu hewan
bekicot = n siput darat pemakan daun-daunan dan batang muda〔Achatina variegata〕
zigot = n Bio tingkat pertumbuhan parasit yang terjadi karena perpaduan gamet betina dengan gamet jantan
babi = n binatang menyusui yang bermoncong panjang, berkulit tebal, dan berbulu kasar|n kas umpatan yang sangat kasar: enyah kau dari sini, --!|n kas nama kartu kecil (kartu ceki)
wisma = n bangunan untuk tempat tinggal, kantor, dan sebagainya; gerha|n kumpulan rumah; kompleks perumahan; permukiman
cuaca = n keadaan udara (tentang suhu, cahaya matahari kelembapan, kecepatan angin, dan sebagainya) pada satu tempat tertentu dengan jangka waktu terbatas: pada waktu -- buruk tidak dapat dilakukan penerbangan; hari ini -- terang
debu = n serbuk halus (dari tanah dan sebagainya); abu; duli; lebu: angin bertiup dan -- beterbangan ke udara
cacing = n binatang kecil, melata, tidak berkaki, tubuhnya bulat atau pipih panjang dan tidak beranggota |(ada yang hidup dalam air, tanah, perut manusia, atau perut binatang)
ekuivalen = a mempunyai nilai (ukuran, arti, atau efek) yang sama; seharga; sebanding; sepadan: pada umumnya pendapat yang menyatakan kultur -- dengan kebu-dayaan dapat diterima
fantasi = n gambar (bayangan) dalam angan-angan; khayalan: cerita itu berdasarkan --, bukan kejadian yang sebenarnya|n daya untuk menciptakan sesuatu dalam angan-angan: pengarang harus kuat --nya|n hiasan tiruan: gaun itu diberi kancing dan saku --
aba = n ayah; bapak|n isyarat berupa bunyi ketukan di dinding dan sebagainya yang biasanya terdengar sebelum kematian salah seorang anggota keluarga
faksi = n Pol kelompok di dalam suatu partai politik, beranggotakan para politisi yang mencoba |menonjolkan diri dengan cara-cara oportunistis atau dengan cara mendorong perpecahan di dalam partai politiknya, bahkan di dalam negara
gambar = n tiruan barang (orang, binatang, tumbuhan, dan sebagainya) yang dibuat dengan coretan pensil dan sebagainya pada kertas dan sebagainya; lukisan
edar = v kitar
ganti = n sesuatu yang menjadi penukar yang tidak ada atau hilang, seperti sulih, pampas: santan ini dapat dipakai akan -- susu|n orang yang menggantikan pekerjaan, jabatan, dan sebagainya; wakil; pengganti: lurah yang meninggal itu belum ada --nya; akulah -- ayahmu|v cak berganti; bertukar; berpindah: -- kereta (api)
handuk = n kain yang mudah menyerap air sebagai penyeka badan; tuala
hormat = Etimologi: [Informasi etimologi hanya tersedia bagi pengguna terdaftar]|a menghargai (takzim, khidmat, sopan): sepatutnyalah kita -- kepada orang tua kita|n perbuatan yang menandakan rasa khidmat atau takzim (seperti menyembah, menunduk): hadirin serentak berdiri memberi -- kepada tamu yang datang
obat = n bahan untuk mengurangi, menghilangkan penyakit, atau menyembuhkan seseorang dari penyakit; daun ketepeng sering dibuat --pencahar|n bahan kimia (untuk pelbagai keperluan): hendak mencuci potret, tetapi tidak ada-nya|n mesiu;peluru:membuang--
oval = a (bentuk) lonjong; bulat panjang; bulat telur
derivasi = n Ling pengimbuhan afiks yang tidak bersifat infleksi pada bentuk dasar untuk membentuk kata
paku = n benda bulat panjang dari logam yang berkepala dan berujung runcing(untuk melekatkan satu tinang dengan tiang lain);pasak
pakaian = n barang yang dipakai (baju, celana, dan sebagainya)
qada = n peraturan, hukum, ketentuan ang berasal dari Allah: seluruh alam semesta tunduk pada Allah Swt.
yaumudin = n Ar hari keputusan untuk memberi balasan yang setimpal; hari kiamat
quran = n Alquran
masyarakat = n sejumlah manusia dalam arti seluas-luasnya dan terikat oleh suatu kebudayaan yang mereka anggap sama: -- terpelajar
rabun = a kurang jelas; kurang awas; kabur(tentang penglihatan): orang tuaitu sudah -- matanya
jaga = v bangun; tidak tidur: -- atau tidurkah orang itu?; -- dari tidur terbangun|v berkawal atau bertugas menjaga keselamatan dan keamanan; piket
sabda = n kata; perkataan(bagi uhan, nabi, raja, dan sebagainya): renungkan-- Rasulullah mengenai kasih sayang sesama umat manusia
sangsi = a bimbang; ragu-ragu: aku masih -- akan kemampuanmu mendaki gunung itu
tindak = n langkah|n perbuatan
tiru = v meniru
kabin = n kamar di dalam kapal|n ruang di dalam pesawat terbang tempat para penumpang|n ruang penumpang dalam mobil
nafkah = n belanja untuk hidup; (uang) pendapatan: suami wajib memberi -- kepada istrinya|n bekal hidup sehari-hari; rezeki: terasa sulit mencari -- di negeri yang tandus itu; mencari -- di rantau
istilah = n kata atau gabungan kata yang dengan cermat mengungkapkan makna konsep, proses, keadaan, atau sifat yang khas dalam bidang tertentu|n sebutan; nama: janda muda disebut dengan -- “janda kembang”|n kata atau ungkapan khusus
ibadah = n perbuatan untuk menyatakan bakti kepada Allah Swt., yang didasari ketaatan mengerjakan perintah-Nya dan menjauhi larangan-Nya; ibadat
realitas = n kenyataan
jadwal = n pembagian waktu berdasarkan rencana pengaturan urutan kerja; daftar atau tabel kegiatan|atau rencana kegiatan dengan pembagian waktu pelaksanaan yang terperinci: -- penataran itu sudah disetujui oleh pimpinan
kabar = n laporan tentang peristiwa yang biasanya belum lama terjadi; berita; warta: dia mendapat -- bahwa saudaranya naik haji
lama = a panjang antaranya (tentang waktu): sudah -- aku menunggu di sini|a panjangnya waktu (antara waktu): berapa jam --nya?; lima bulan --nya|a kuno; sejak dahulu kala; dahulu telah ada: saya senang mempelajari kesusastraan --|a tua (tidak baru); usang: diberikannya baju-baju --nya kepada fakir miskin
mahal = a tinggi harganya: karena senangnya pada barang itu, biarpun -- dibelinya juga|a jarang ada; sukar terdapat; tidak mudah: barang itu -- dibeli sukar dicari; -- mencari orang yang sebaik itu
nadi = n pembuluh darah di pergelangan tangan (terasa berdenyut kalau ditekan); urat nadi: dokter memegang -- si sakit untuk mengetahui apakah masih berdenyut atau tidak|n pembuluh darah besar; aorta; batang nadi
labil = v goyah; tidak mantap; tidak kokoh (tentang bangunan, pendirian, dan sebagainya)|v goyang; tidak tenang (tentang kendaraan, kapal, pesawat terbang, dan sebagainya)|v tidak tetap; mudah berubah-ubah; naik turun (tentang harga barang, nilai uang, dan sebagainya)|v tidak stabil; cenderung berubah|v Fis tidak seimbang dan mudah berubah